,article.date,good,bad,overall,lag.overall,percentage_change
1,01-12-20,5,3,2,-1,0.000899671
2,30-11-20,13,5,8,2,0.05629962
3,29-11-20,5,3,2,8,0.034757238
4,28-11-20,5,8,-3,2,0.026983577
5,27-11-20,11,11,0,-3,-0.012369568
6,26-11-20,11,8,3,0,-0.110930247
7,25-11-20,13,8,5,3,0.005938985
8,24-11-20,4,8,-4,5,0.026261688
9,23-11-20,6,10,-4,-4,0.008199593
10,22-11-20,6,6,0,-4,-0.02288277
11,21-11-20,4,8,-4,0,0.018190665
12,20-11-20,11,13,-2,-4,0.031458137
13,19-11-20,5,10,-5,-2,-0.00461142
14,18-11-20,9,14,-5,-5,0.034351097
15,17-11-20,4,16,-12,-5,0.04926095
16,16-11-20,5,10,-5,-12,0.026237836
17,15-11-20,6,4,2,-5,-0.000224465
18,14-11-20,7,4,3,2,-0.018532384
19,13-11-20,11,4,7,3,0.020870606
20,12-11-20,6,7,-1,7,0.018000082
21,11-11-20,6,17,-11,-1,0.020902607
22,10-11-20,10,20,-10,-11,-0.002544938
23,09-11-20,7,2,5,-10,0.007111003
24,08-11-20,9,5,4,5,0.011674576
25,07-11-20,4,5,-1,4,-0.032736603
26,06-11-20,6,7,-1,-1,0.04067303
27,05-11-20,10,8,2,-1,0.068893585
28,04-11-20,9,4,5,2,0.019787
29,03-11-20,4,9,-5,5,0.006435531
30,02-11-20,5,14,-9,-5,-0.016039577
31,01-11-20,5,0,5,-9,-0.000266203
32,31-10-20,5,7,-2,5,0.026124104
33,30-10-20,10,7,3,-2,0.006375719
34,29-10-20,2,3,-1,3,-0.003828264
35,28-10-20,0,2,-2,-1,-0.005540057
36,27-10-20,2,4,-2,-2,0.028488441
37,26-10-20,7,7,0,-2,-0.001104313
38,25-10-20,6,4,2,0,0.001832741
39,24-10-20,3,3,0,2,0.010639741
40,23-10-20,5,3,2,0,-0.003766204
41,22-10-20,3,1,2,2,0.02923825
42,21-10-20,2,3,-1,2,0.055996109
43,20-10-20,3,9,-6,-1,0.01855255
44,19-10-20,2,11,-9,-6,0.018151366
45,18-10-20,7,5,2,-9,0.009327597
46,17-10-20,6,3,3,2,0.000463815
47,16-10-20,5,6,-1,3,-0.006862043
48,15-10-20,3,3,0,-1,0.000487974
49,14-10-20,2,9,-7,0,-0.002233807
50,13-10-20,3,6,-3,-7,-0.002850522
51,12-10-20,3,13,-10,-3,0.00834751
52,11-10-20,3,12,-9,-10,0.002526524
53,10-10-20,2,8,-6,-9,0.028954487
54,09-10-20,3,7,-4,-6,0.021373736
55,08-10-20,5,11,-6,-4,0.014316347
56,07-10-20,4,4,0,-6,-0.002050913
57,06-10-20,3,5,-2,0,-0.006300686
58,05-10-20,2,7,-5,-2,0.008202695
59,04-10-20,8,9,-1,-5,0.006683933
60,03-10-20,5,8,-3,-1,0.003611332
61,02-10-20,4,8,-4,-3,-0.01656622
62,01-10-20,6,5,1,-4,-0.005076882
63,30-09-20,5,8,-3,1,0.001155994
64,29-09-20,3,9,-6,-3,-0.012984442
65,28-09-20,4,17,-13,-6,0.014620123
66,27-09-20,2,11,-9,-13,-0.001086813
67,26-09-20,2,6,-4,-9,0.005797173
68,25-09-20,1,3,-2,-4,0.014599367
69,24-09-20,0,1,-1,-2,0.012022736
70,23-09-20,4,1,3,-1,-0.008343882
71,22-09-20,6,5,1,3,-0.010151826
72,21-09-20,4,5,-1,1,-0.03139763
73,20-09-20,6,0,6,-1,-0.012739924
74,19-09-20,5,4,1,6,0.011090718
75,18-09-20,3,4,-1,1,0.00455577
76,17-09-20,1,6,-5,-1,-0.006218032
77,16-09-20,4,4,0,-5,0.012983037
78,15-09-20,6,7,-1,0,0.022997731
79,14-09-20,6,12,-6,-1,0.018764077
80,13-09-20,4,1,3,-6,-0.002132116
81,12-09-20,4,1,3,3,0.006902729
82,11-09-20,1,5,-4,3,-0.003951638
83,10-09-20,1,4,-3,-4,0.013896587
84,09-09-20,7,7,0,-3,0.009750348
85,08-09-20,15,6,9,0,-0.000940862
86,07-09-20,1,8,-7,9,-0.008338275
87,06-09-20,4,10,-6,-7,-0.000304117
88,05-09-20,5,3,2,-6,-0.017004703
89,04-09-20,4,6,-2,2,-0.037529503
90,03-09-20,0,9,-9,-2,-0.065079967
91,02-09-20,11,9,2,-9,-0.038228797
92,01-09-20,7,7,0,2,0.017383131
93,31-08-20,13,2,11,0,0.005535082
94,30-08-20,6,4,2,11,0.009855073
95,29-08-20,4,10,-6,2,0.004843829
96,28-08-20,2,9,-7,-6,0.009266341
97,27-08-20,6,7,-1,-7,-0.003066055
98,26-08-20,4,5,-1,-1,-0.003069931
99,25-08-20,5,7,-2,-1,-0.028805111
100,24-08-20,10,6,4,-2,0.010562973
101,23-08-20,1,6,-5,4,0.006635846
102,22-08-20,2,3,-1,-5,-0.015170706
103,21-08-20,2,1,1,-1,-0.007038072
104,20-08-20,3,8,-5,1,0.002349564
105,19-08-20,2,7,-5,-5,-0.02621937
106,18-08-20,4,3,1,-5,-0.006832943
107,17-08-20,5,7,-2,1,0.027000378
108,16-08-20,2,5,-3,-2,-0.00302607
109,15-08-20,4,1,3,-3,0.010481283
110,14-08-20,4,1,3,3,0.018258779
111,13-08-20,1,1,0,3,0.006040435
112,12-08-20,6,4,2,0,-0.007591864
113,11-08-20,2,4,-2,2,-0.028599731
114,10-08-20,0,5,-5,-2,0.018174844
115,09-08-20,2,6,-4,-5,-0.002302729
116,08-08-20,2,6,-4,-4,0.003869579
117,07-08-20,2,3,-1,-4,-0.009251398
118,06-08-20,1,7,-6,-1,0.016914037
119,05-08-20,3,2,1,-6,0.029424166
120,04-08-20,2,5,-3,1,-0.005963754
121,03-08-20,7,9,-2,-3,0.000179957
122,02-08-20,7,2,5,-2,-0.031010764
123,01-08-20,7,5,2,5,0.033596212
124,31-07-20,4,3,1,2,0.019294627
125,30-07-20,5,2,3,1,-0.009547029
126,29-07-20,4,6,-2,3,0.014735491
127,28-07-20,1,9,-8,-2,0.03743399
128,27-07-20,6,1,5,-8,0.060542515
129,26-07-20,7,6,1,5,0.028137344
130,25-07-20,5,9,-4,1,0.007703291
131,24-07-20,4,1,3,-4,0.001771881
132,23-07-20,1,1,0,3,0.016349687
133,22-07-20,1,4,-3,0,0.00525146
134,21-07-20,4,2,2,-3,0.017718303
135,20-07-20,5,4,1,2,0.001864878
136,19-07-20,3,8,-5,1,-0.000857417
137,18-07-20,4,8,-4,-5,0.003687704
138,17-07-20,5,6,-1,-4,0.002595219
139,16-07-20,3,7,-4,-1,-0.011510321
140,15-07-20,4,5,-1,-4,-0.000333427
141,14-07-20,4,8,-4,-1,-0.006932018
142,13-07-20,5,2,3,-4,0.002578828
143,12-07-20,3,4,-1,3,0.002366974
144,11-07-20,5,11,-6,-1,0.005173082
145,10-07-20,2,8,-6,-6,-0.012153169
146,09-07-20,1,6,-5,-6,-0.005506233
147,08-07-20,6,9,-3,-5,0.009229038
148,07-07-20,3,1,2,-3,0.002029341
149,06-07-20,4,1,3,2,0.02105498
150,05-07-20,7,7,0,3,-0.006094398
151,04-07-20,6,9,-3,0,0.001577543
152,03-07-20,2,1,1,-3,-0.001862195
153,02-07-20,5,1,4,1,-0.011072697
154,01-07-20,4,4,0,4,0.007330209
155,30-06-20,4,5,-1,0,0.003823994
156,29-06-20,2,9,-7,-1,0.003033679
157,28-06-20,4,3,1,-7,0.006421659
158,27-06-20,3,9,-6,1,-0.014431491
159,26-06-20,7,5,2,-6,-0.004962324
160,25-06-20,3,2,1,2,-0.020517475
161,24-06-20,1,10,-9,1,-0.027327572
162,23-06-20,3,4,-1,-9,0.010923848
163,22-06-20,1,3,-2,-1,0.019961573
164,21-06-20,2,3,-1,-2,0.004552885
165,20-06-20,4,4,0,-1,-0.001980586
166,19-06-20,3,4,-1,0,-0.008064325
167,18-06-20,3,11,-8,-1,-0.003223844
168,17-06-20,4,0,4,-8,-0.007033628
169,16-06-20,3,8,-5,4,0.032078479
170,15-06-20,5,4,1,-5,-0.01985179
171,14-06-20,5,1,4,1,-0.006175505
172,13-06-20,1,3,-2,4,0.001751672
173,12-06-20,1,7,-6,-2,-0.011961078
174,11-06-20,4,7,-3,-6,-0.03129307
175,10-06-20,8,5,3,-3,0.010265237
176,09-06-20,5,4,1,3,-0.000603005
177,08-06-20,4,4,0,1,0.013898787
178,07-06-20,0,3,-3,0,-0.00319472
179,06-06-20,0,3,-3,-3,-0.010570195
180,05-06-20,2,2,0,-3,0.001318706
181,04-06-20,4,1,3,0,0.016638118
182,03-06-20,5,1,4,3,-0.026564929
183,02-06-20,4,7,-3,4,-0.006499708
184,01-06-20,8,10,-2,-3,0.033763605
185,31-05-20,6,1,5,-2,-0.000754287
186,30-05-20,6,7,-1,5,0.009135362
187,29-05-20,5,3,2,-1,0.006886442
188,28-05-20,7,1,6,2,0.031570317
189,27-05-20,7,3,4,6,0.026997764
190,26-05-20,8,14,-6,4,0.005286121
191,25-05-20,10,14,-4,-6,-0.023853159
192,24-05-20,9,10,-1,-4,-0.020273186
193,23-05-20,2,5,-3,-1,0.006905318
194,22-05-20,3,3,0,-3,-0.004023469
195,21-05-20,0,7,-7,0,-0.044954097
196,20-05-20,2,4,-2,-7,-0.010592269
197,19-05-20,4,3,1,-2,-0.00554773
198,18-05-20,5,1,4,1,0.003101326
199,17-05-20,6,4,2,4,0.02994329
200,16-05-20,9,4,5,2,-0.008506076
201,15-05-20,6,7,-1,5,-0.017696549
202,14-05-20,3,2,1,-1,0.05860173
203,13-05-20,0,0,0,1,0.033722528
204,12-05-20,0,0,0,0,0.012095614
205,11-05-20,0,2,-2,0,3.14E-05
206,10-05-20,0,0,0,-2,-0.118418241
207,09-05-20,0,0,0,0,-0.021353219
208,08-05-20,0,1,-1,0,0.027120395
209,07-05-20,0,0,0,-1,0.04552365
210,06-05-20,0,0,0,0,0.03002262
211,05-05-20,0,0,0,0,0.01809726
212,04-05-20,0,0,0,0,-0.025690978
213,03-05-20,0,0,0,0,0.010426036
214,02-05-20,0,0,0,0,0.010395201
215,01-05-20,0,0,0,0,-0.01326921
216,30-04-20,0,0,0,0,0.066859683
217,29-04-20,0,0,0,0,0.07322901
218,28-04-20,0,0,0,0,0.000495462
219,27-04-20,0,1,-1,0,0.013299379
220,26-04-20,0,0,0,-1,0.006709189
221,25-04-20,0,0,0,0,0.00460815
222,24-04-20,0,0,0,0,0.016828089
223,23-04-20,0,0,0,0,0.046869481
224,22-04-20,0,0,0,0,0.027495128
225,21-04-20,0,0,0,0,-0.018259789
226,20-04-20,0,0,0,0,-0.025283438
227,19-04-20,0,0,0,0,-0.001686349
228,18-04-20,0,0,0,0,0.014242332
229,17-04-20,0,0,0,0,0.015343683
230,16-04-20,0,1,-1,0,0.027416392
231,15-04-20,0,0,0,-1,-0.016010272
232,14-04-20,2,3,-1,0,0.020058185
233,13-04-20,3,2,1,-1,-0.04254232
234,12-04-20,0,3,-3,1,0.023412714
235,11-04-20,3,4,-1,-3,-0.010573856
236,10-04-20,3,3,0,-1,-0.051660153
237,09-04-20,1,4,-3,0,-0.001454779
238,08-04-20,2,2,0,-3,0.000710927
239,07-04-20,2,2,0,0,0.02480497
240,06-04-20,4,3,1,0,0.046541746
241,05-04-20,5,3,2,1,-0.002584711
242,04-04-20,5,4,1,2,-0.005804368
243,03-04-20,1,5,-4,1,0.003680127
244,02-04-20,2,2,0,-4,0.067886955
245,01-04-20,2,1,1,0,-0.014113006
246,31-03-20,3,0,3,1,0.020219473
247,30-03-20,0,3,-3,3,0.042662696
248,29-03-20,1,6,-5,-3,-0.027305981
249,28-03-20,0,5,-5,-5,-0.070047676
250,27-03-20,0,5,-5,-5,-0.002937555
251,26-03-20,3,2,1,-5,-0.002139813
252,25-03-20,0,3,-3,1,0.002833419
253,24-03-20,2,1,1,-3,0.067423541
254,23-03-20,5,4,1,1,0.028755909
255,22-03-20,1,1,0,1,-0.01961137
256,21-03-20,0,0,0,0,-0.045087622
257,20-03-20,3,5,-2,0,0.082284343
258,19-03-20,4,4,0,-2,0.109482759
259,18-03-20,3,2,1,0,-0.011694626
260,17-03-20,5,1,4,1,0.082758771
261,16-03-20,5,3,2,4,-0.109436805
262,15-03-20,5,2,3,2,0.003440689
263,14-03-20,3,5,-2,3,0.031163665
264,13-03-20,1,2,-1,-2,-0.17850153
265,12-03-20,2,0,2,-1,-0.267157113
266,11-03-20,8,5,3,2,-0.018537444
267,10-03-20,2,5,-3,3,0.009155866
268,09-03-20,1,2,-1,-3,-0.066397991
269,08-03-20,2,4,-2,-1,-0.077320019
270,07-03-20,1,1,0,-2,-0.006183319
271,06-03-20,2,3,-1,0,0.007144878
272,05-03-20,0,1,-1,-1,0.031547233
273,04-03-20,2,2,0,-1,-0.003717309
274,03-03-20,1,4,-3,0,-0.000288072
275,02-03-20,2,2,0,-3,0.027533106
276,01-03-20,0,1,-1,0,-0.015598746
277,29-02-20,0,3,-3,-1,0.0037637
278,28-02-20,3,1,2,-3,-0.016857105
279,27-02-20,3,4,-1,2,-0.02140408
280,26-02-20,1,3,-2,-1,-0.053273378
281,25-02-20,0,3,-3,-2,-0.027883794
282,24-02-20,3,0,3,-3,-0.017552484
283,23-02-20,1,0,1,3,0.023287495
284,22-02-20,0,0,0,1,-0.003424615
285,21-02-20,0,10,-10,0,0.012470372
286,20-02-20,2,5,-3,-10,-0.038549632
287,19-02-20,3,3,0,-3,-9.80E-05
288,18-02-20,0,3,-3,0,0.026158185
289,17-02-20,0,2,-2,-3,-0.018924798
290,16-02-20,4,0,4,-2,-0.01902049
291,15-02-20,0,5,-5,4,-0.01981836
292,14-02-20,0,2,-2,-5,-0.001444748
293,13-02-20,2,2,0,-2,-0.007592687
294,12-02-20,4,2,2,0,0.026871987
295,11-02-20,0,4,-4,2,0.015118381
296,10-02-20,7,3,4,-4,-0.015183256
297,09-02-20,4,0,4,4,0.025449339
298,08-02-20,1,6,-5,4,0.002409081
299,07-02-20,3,3,0,-5,0.007189105
300,06-02-20,3,1,2,0,0.023374364
301,05-02-20,1,2,-1,2,0.03048607
302,04-02-20,3,3,0,-1,-0.017632301
303,03-02-20,4,0,4,0,0.001949437
304,02-02-20,0,2,-2,4,-0.003461654
305,01-02-20,1,0,1,-2,0.003930204
306,31-01-20,3,4,-1,1,-0.006213948
307,30-01-20,0,0,0,-1,0.00648799
308,29-01-20,4,2,2,0,0.026038468
309,28-01-20,1,3,-2,2,0.034711093
310,27-01-20,2,1,1,-2,0.039467867
311,26-01-20,0,1,-1,1,0.012087675
312,25-01-20,2,0,2,-1,-0.005461206
313,24-01-20,1,1,0,2,-0.004167852
314,23-01-20,1,5,-4,0,-0.029921756
315,22-01-20,0,0,0,-4,0.002847732
316,21-01-20,1,1,0,0,-0.00011646
317,20-01-20,3,2,1,0,-0.016839943
318,19-01-20,1,0,1,1,-0.013035691
319,18-01-20,0,2,-2,1,0.001193837
320,17-01-20,5,1,4,-2,0.025585663
321,16-01-20,4,0,4,4,-0.011759143
322,15-01-20,3,4,-1,4,0.018704748
323,14-01-20,1,2,-1,-1,0.057735756
324,13-01-20,4,2,2,-1,-0.001004115
325,12-01-20,4,0,4,2,-0.00169851
326,11-01-20,3,0,3,4,0.022058008
327,10-01-20,2,0,2,3,0.006357667
328,09-01-20,3,3,0,2,-0.041508522
329,08-01-20,2,1,1,0,0.035853921
330,07-01-20,1,1,0,1,0.040818822
331,06-01-20,3,0,3,0,0.022944659
332,05-01-20,1,5,-4,3,0.015056193
333,04-01-20,1,0,1,-4,0.011694258
334,03-01-20,0,0,0,1,0.027658239
335,02-01-20,2,0,2,0,-0.023475175
336,01-01-20,2,0,2,2,7.84E-05
337,31-12-19,0,3,-3,2,-0.012013699
338,30-12-19,1,0,1,-3,-0.016310409
339,29-12-19,2,1,1,1,0.013777396
340,28-12-19,0,0,0,1,0.016552666
341,27-12-19,0,1,-1,0,-0.011546802
342,26-12-19,1,4,-3,-1,0.008998536
343,25-12-19,1,5,-4,-3,-0.015199436
344,24-12-19,1,2,-1,-4,-0.025510399
345,23-12-19,2,5,-3,-1,0.01797825
346,22-12-19,0,0,0,-3,0.029078091
347,21-12-19,0,0,0,0,-0.001652644
348,20-12-19,0,2,-2,0,0.002626646
349,19-12-19,3,2,1,-2,0.042930002
350,18-12-19,4,6,-2,1,0.01311863
351,17-12-19,3,2,1,-2,-0.036042628
352,16-12-19,3,3,0,1,-0.01739995
353,15-12-19,2,1,1,0,-0.002793792
354,14-12-19,2,0,2,1,-0.014711073
355,13-12-19,3,5,-2,2,0.006344064
356,12-12-19,3,5,-2,-2,-0.00328902
357,11-12-19,2,5,-3,-2,-0.010816787
358,10-12-19,1,8,-7,-3,-0.021702045
359,09-12-19,5,4,1,-7,-0.007441335
360,08-12-19,1,1,0,1,-0.006617695
361,07-12-19,0,3,-3,0,0.013959514
362,06-12-19,2,5,-3,-3,0.012644298
363,05-12-19,0,3,-3,-3,-0.000579424
364,04-12-19,2,1,1,-3,0.004198684
365,03-12-19,3,2,1,1,0.004288455
366,02-12-19,0,6,-6,1,-0.009714311
367,01-12-19,1,1,0,-6,-0.037080523
368,30-11-19,0,0,0,0,-0.002434652
369,29-11-19,0,2,-2,0,0.01700472
370,28-11-19,2,3,-1,-2,0.032048673
371,27-11-19,1,6,-5,-1,0.019480917
372,26-11-19,0,4,-4,-5,0.031759531
373,25-11-19,4,0,4,-4,-0.026757575
374,24-11-19,2,1,1,4,-0.01817171
375,23-11-19,0,1,-1,1,0.003426012
376,22-11-19,3,1,2,-1,-0.072913501
377,21-11-19,5,1,4,2,-0.048319068
378,20-11-19,3,2,1,4,0.000177158
379,19-11-19,1,2,-1,1,-0.025855605
380,18-11-19,2,5,-3,-1,-0.025466515
381,17-11-19,0,2,-2,-3,0.005221466
382,16-11-19,1,1,0,-2,-0.009366076
383,15-11-19,0,6,-6,0,-0.009854146
384,14-11-19,5,4,1,-6,-0.013015139
385,13-11-19,3,3,0,1,0.003525393
386,12-11-19,6,4,2,0,-0.003035378
387,11-11-19,2,2,0,2,-0.02608211
388,10-11-19,3,0,3,0,0.018317343
389,09-11-19,0,0,0,3,-0.010713634
390,08-11-19,1,2,-1,0,-0.035314069
391,07-11-19,5,4,1,-1,-0.013096274
392,06-11-19,5,2,3,1,0.001226715
393,05-11-19,3,1,2,3,-0.001273728
394,04-11-19,2,3,-1,2,0.017048067
395,03-11-19,3,3,0,-1,-0.011172816
396,02-11-19,2,0,2,0,0.013193151
397,01-11-19,3,1,2,2,-0.00161112
398,31-10-19,6,1,5,2,0.001530625
399,30-10-19,6,4,2,5,-0.024195827
400,29-10-19,0,2,-2,2,-0.012929795
401,28-10-19,3,1,2,-2,4.54E-05
402,27-10-19,0,1,-1,2,0.010493768
403,26-10-19,1,0,1,-1,0.12612774
404,25-10-19,5,5,0,1,0.093963727
405,24-10-19,6,2,4,0,-0.01741168
406,23-10-19,3,4,-1,4,-0.080268222
407,22-10-19,4,1,3,-1,-0.00496197
408,21-10-19,3,6,-3,3,0.016732379
409,20-10-19,0,0,0,-3,0.015412198
410,19-10-19,2,1,1,0,0.003904436
411,18-10-19,0,2,-2,1,-0.015699036
412,17-10-19,1,8,-7,-2,0.004557781
413,16-10-19,3,1,2,-7,-0.029560908
414,15-10-19,2,2,0,2,-0.007059713
415,14-10-19,2,3,-1,0,-0.003370657
416,13-10-19,0,0,0,-1,0.000642839
417,12-10-19,2,1,1,0,-0.0122124
418,11-10-19,2,3,-1,1,-0.013782943
419,10-10-19,3,3,0,-1,0.012052304
420,09-10-19,6,8,-2,0,0.028875297
421,08-10-19,3,4,-1,-2,0.016464703
422,07-10-19,3,4,-1,-1,0.015134265
423,06-10-19,1,0,1,-1,-0.019170274
424,05-10-19,1,5,-4,1,-0.005622032
425,04-10-19,1,2,-1,-4,-0.007023478
426,03-10-19,2,3,-1,-1,-0.005815019
427,02-10-19,2,5,-3,-1,-0.015784565
428,01-10-19,2,2,0,-3,0.037692694
429,30-09-19,1,6,-5,0,0.001771086
430,29-09-19,1,3,-2,-5,-0.01389947
431,28-09-19,2,1,1,-2,0.016084613
432,27-09-19,2,7,-5,1,-0.01164067
433,26-09-19,3,7,-4,-5,-0.038125922
434,25-09-19,2,1,1,-4,-0.046826738
435,24-09-19,4,4,0,1,-0.112178706
436,23-09-19,5,4,1,0,-0.015484558
437,22-09-19,0,0,0,1,-0.003872563
438,21-09-19,0,1,-1,0,-0.014429575
439,20-09-19,4,5,-1,-1,0.018608296
440,19-09-19,3,2,1,-1,-0.021752147
441,18-09-19,1,3,-2,1,-0.002023531
442,17-09-19,2,1,1,-2,-0.001892396
443,16-09-19,3,6,-3,1,-0.007739532
444,15-09-19,3,3,0,-3,-0.004990268
445,14-09-19,1,1,0,0,0.005441621
446,13-09-19,4,5,-1,0,0.004549881
447,12-09-19,3,4,-1,-1,0.018965459
448,11-09-19,4,3,1,-1,-0.006186065
449,10-09-19,4,2,2,1,-0.017757812
450,09-09-19,1,1,0,2,-0.010891879
451,08-09-19,0,1,-1,0,-0.005042738
452,07-09-19,1,1,0,-1,-0.016048725
453,06-09-19,3,4,-1,0,0.007002035
454,05-09-19,3,2,1,-1,-0.000651981
455,04-09-19,5,3,2,1,-0.000125008
456,03-09-19,2,1,1,2,0.041614435
457,02-09-19,7,5,2,1,0.045990152
458,01-09-19,0,1,-1,2,0.007986304
459,31-08-19,3,0,3,-1,0.004290246
460,30-08-19,0,1,-1,3,0.00621597
461,29-08-19,1,3,-2,-1,-0.044273147
462,28-08-19,3,0,3,-2,-0.025925837
463,27-08-19,3,3,0,3,-0.022082347
464,26-08-19,3,6,-3,0,0.027380362
465,25-08-19,0,2,-2,-3,0.000397629
466,24-08-19,0,0,0,-2,-0.019494574
467,23-08-19,2,7,-5,0,0.027974093
468,22-08-19,3,8,-5,-5,-0.015607854
469,21-08-19,5,3,2,-5,-0.058028726
470,20-08-19,1,3,-2,2,0.006533269
471,19-08-19,1,1,0,-2,0.033860254
472,18-08-19,0,0,0,0,0.009018499
473,17-08-19,0,1,-1,0,0.007939758
474,16-08-19,5,3,2,-1,0.020063919
475,15-08-19,4,2,2,2,-0.043681502
476,14-08-19,1,3,-2,2,-0.064305721
477,13-08-19,1,1,0,-2,-0.029674519
478,12-08-19,4,1,3,0,-5.10E-05
479,11-08-19,1,2,-1,3,-0.01419338
480,10-08-19,0,1,-1,-1,-0.024458014
481,09-08-19,1,2,-1,-1,0.001728842
482,08-08-19,2,5,-3,-1,0.002301995
483,07-08-19,2,7,-5,-3,-0.001640343
484,06-08-19,4,5,-1,-5,0.010289517
485,05-08-19,4,5,-1,-1,0.070557495
486,04-08-19,0,1,-1,-1,0.005455489
487,03-08-19,0,1,-1,-1,0.027580599
488,02-08-19,5,1,4,-1,0.034974538
489,01-08-19,3,1,2,4,0.023948685
490,31-07-19,2,2,0,2,0.031443117
491,30-07-19,1,3,-2,0,0.003675829
492,29-07-19,5,4,1,-2,0.010734801
493,28-07-19,0,2,-2,1,-0.01914978
494,27-07-19,2,0,2,-2,-0.017146295
495,26-07-19,7,4,3,2,-0.023995576
496,25-07-19,1,2,-1,3,0.029716561
497,24-07-19,0,1,-1,-1,-0.032683934
498,23-07-19,0,3,-3,-1,-0.033734574
499,22-07-19,2,2,0,-3,-0.019954037
500,21-07-19,1,1,0,0,-0.013278137
501,20-07-19,0,0,0,0,0.026117521
502,19-07-19,3,3,0,0,0.032258359
503,18-07-19,1,3,-2,0,0.056595396
504,17-07-19,5,8,-3,-2,-0.047531454
505,16-07-19,1,2,-1,-3,-0.039386236
506,15-07-19,3,5,-2,-1,-0.025025971
507,14-07-19,0,2,-2,-2,-0.061105515
508,13-07-19,1,0,1,-2,-0.023730786
509,12-07-19,1,5,-4,1,0.002764351
510,11-07-19,2,2,0,-4,-0.087115123
511,10-07-19,1,5,-4,0,0.002142804
512,09-07-19,2,0,2,-4,0.043950641
513,08-07-19,2,4,-2,2,0.049793937
514,07-07-19,0,1,-1,-2,-0.005617345
515,06-07-19,1,2,-1,-1,0.026071879
516,05-07-19,4,2,2,-1,-0.053573439
517,04-07-19,0,3,-3,2,0.029499337
518,03-07-19,6,1,5,-3,0.103856284
519,02-07-19,5,3,2,5,-0.041887065
520,01-07-19,1,4,-3,2,-0.065033901
521,30-06-19,0,1,-1,-3,-0.045110681
522,29-06-19,1,0,1,-1,0.013217782
523,28-06-19,2,5,-3,1,0.009069456
524,27-06-19,0,4,-4,-3,-0.101578481
525,26-06-19,4,2,2,-4,0.10945745
526,25-06-19,2,3,-1,2,0.043074651
527,24-06-19,4,4,0,-1,0.002798036
528,23-06-19,1,6,-5,0,0.009160516
529,22-06-19,0,2,-2,-5,0.083262345
530,21-06-19,1,3,-2,-2,0.044677735
531,20-06-19,0,7,-7,-2,0.02457626
532,19-06-19,0,0,0,-7,0.002792076
533,18-06-19,3,7,-4,0,-0.013668181
534,17-06-19,3,3,0,-4,0.014355069
535,16-06-19,0,1,-1,0,0.04095484
536,15-06-19,0,0,0,-1,0.038899434
537,14-06-19,5,2,3,0,0.026432713
538,13-06-19,3,5,-2,3,0.015236889
539,12-06-19,3,2,1,-2,0.022507055
540,11-06-19,1,0,1,1,0.003942621
541,10-06-19,2,2,0,1,0.01450556
542,09-06-19,0,2,-2,0,-0.023420118
543,08-06-19,0,0,0,-2,-0.004960224
544,07-06-19,0,5,-5,0,0.032410099
545,06-06-19,4,4,0,-5,-0.009383911
546,05-06-19,0,1,-1,0,-0.005871013
547,04-06-19,1,0,1,-1,-0.081246877
548,03-06-19,2,1,1,1,-0.030255967
549,01-06-19,0,0,0,1,0.024271027
550,31-05-19,0,2,-2,0,-0.029060811
551,30-05-19,1,3,-2,-2,-0.005401782
552,29-05-19,6,2,4,-2,-0.009890909
553,28-05-19,1,1,0,4,-0.009239816
554,27-05-19,0,0,0,0,0.041242609
555,26-05-19,1,3,-2,0,0.044364382
556,25-05-19,1,0,1,-2,0.004796762
557,24-05-19,3,1,2,1,0.03752479
558,23-05-19,4,1,3,2,-0.016494217
559,22-05-19,6,4,2,3,-0.012656559
560,21-05-19,3,7,-4,2,0.004842338
561,20-05-19,1,2,-1,-4,-0.005589603
562,19-05-19,0,1,-1,-1,0.077470076
563,18-05-19,1,0,1,-1,0.022971189
564,17-05-19,1,4,-3,1,-0.116329886
565,16-05-19,2,1,1,-3,-0.007657239
566,15-05-19,3,6,-3,1,0.007173773
567,14-05-19,3,2,1,-3,0.048804205
568,13-05-19,0,4,-4,1,0.055742904
569,12-05-19,0,0,0,-4,0.03944477
570,11-05-19,0,2,-2,0,0.088030663
571,10-05-19,1,5,-4,-2,0.040585066
572,09-05-19,1,4,-3,-4,0.03265285
573,08-05-19,6,5,1,-3,-0.003481122
574,07-05-19,5,4,1,1,0.035409734
575,06-05-19,5,4,1,1,-0.011512468
576,05-05-19,2,2,0,1,0.004053837
577,04-05-19,2,1,1,0,0.008734806
578,03-05-19,4,4,0,1,0.049241804
579,02-05-19,7,1,6,0,0.01190611
580,01-05-19,2,1,1,6,0.017530368
581,30-04-19,0,2,-2,1,0.011999917
582,29-04-19,1,0,1,-2,-0.002964072
583,28-04-19,0,1,-1,1,0.000467261
584,27-04-19,0,0,0,-1,0.001080757
585,26-04-19,0,1,-1,0,-0.033469414
586,25-04-19,2,4,-2,-1,-0.02869033
587,24-04-19,2,6,-4,-2,-0.010700124
588,23-04-19,1,2,-1,-4,0.037538443
589,22-04-19,4,1,3,-1,0.010797674
590,21-04-19,0,1,-1,3,-0.007479736
591,20-04-19,1,3,-2,-1,0.010699306
592,19-04-19,1,0,1,-2,-0.00184809
593,18-04-19,4,1,3,1,0.009084713
594,17-04-19,2,0,2,3,0.020131575
595,16-04-19,3,2,1,2,0.001963518
596,15-04-19,4,2,2,1,0.003860143
597,14-04-19,0,2,-2,2,-0.000566685
598,13-04-19,1,2,-1,-2,0.009172504
599,12-04-19,4,0,4,-1,-0.015608722
600,11-04-19,5,2,3,4,-0.033449799
601,10-04-19,2,0,2,3,0.014251529
602,09-04-19,7,6,1,2,-0.004561844
603,08-04-19,7,4,3,1,0.018963594
604,07-04-19,5,9,-4,3,0.012265223
605,06-04-19,3,7,-4,-4,0.018096149
606,05-04-19,6,5,1,-4,0.005096651
607,04-04-19,5,5,0,1,-0.02081974
608,03-04-19,3,9,-6,0,0.067975186
609,02-04-19,6,1,5,-6,0.126585071
610,01-04-19,9,8,1,5,0.007904794
611,31-03-19,3,3,0,1,0.000675802
612,30-03-19,5,2,3,0,0.005388963
613,29-03-19,9,5,4,3,0.013496503
614,28-03-19,9,8,1,4,0.002627218
615,27-03-19,6,7,-1,1,0.022823805
616,26-03-19,7,5,2,-1,-0.006616721
617,25-03-19,5,1,4,2,-0.008512195
618,24-03-19,1,0,1,4,-0.003729398
619,23-03-19,0,0,0,1,-2.15E-05
620,22-03-19,5,4,1,0,-0.00485745
621,21-03-19,6,6,0,1,0.000736191
622,20-03-19,4,7,-3,0,0.004869158
623,19-03-19,2,0,2,-3,0.002629643
624,18-03-19,1,3,-2,2,0.001484581
625,17-03-19,0,0,0,-2,-0.005540141
626,16-03-19,4,5,-1,0,0.026131268
627,15-03-19,0,0,0,-1,0.008091879
628,14-03-19,0,3,-3,0,-0.000966105
629,13-03-19,0,5,-5,-3,0.001653015
630,12-03-19,4,4,0,-5,-0.00344322
631,11-03-19,0,1,-1,0,-0.008194535
632,08-03-19,1,7,-6,-1,0.001335041
633,07-03-19,4,3,1,-6,0.005042102
634,06-03-19,1,2,-1,1,0.017006737
635,05-03-19,0,0,0,-1,0.016051123
636,04-03-19,0,0,0,0,-0.021756219
637,03-03-19,0,0,0,0,-0.001311373
638,01-03-19,0,0,0,0,0.000196643
639,28-02-19,0,1,-1,0,0.010340526
640,27-02-19,0,2,-2,-1,-0.005276459
641,26-02-19,1,0,1,-2,-0.00013707
642,25-02-19,0,4,-4,1,-0.027814445
643,24-02-19,0,0,0,-4,-0.030342166
644,23-02-19,0,0,0,0,0.023790871
645,22-02-19,0,0,0,0,0.004490819
646,21-02-19,0,1,-1,0,-0.001518074
647,19-02-19,0,0,0,-1,0.034785774
648,18-02-19,0,1,-1,0,0.046653176
649,17-02-19,0,0,0,-1,0.001594841
650,15-02-19,0,0,0,0,0.00143495
651,14-02-19,1,0,1,0,-0.003568187
652,13-02-19,2,0,2,1,0.000569233
653,12-02-19,0,0,0,2,-0.005217326
654,11-02-19,0,0,0,0,-0.003383721
655,10-02-19,0,0,0,0,-0.001893098
656,09-02-19,0,0,0,0,0.034112276
657,08-02-19,3,1,2,0,0.036409688
658,07-02-19,5,2,3,2,-0.002276993
659,06-02-19,0,3,-3,3,-0.01432857
660,05-02-19,5,0,5,-3,0.002169864
661,04-02-19,0,1,-1,5,-0.002133707
662,03-02-19,0,0,0,-1,-0.00468689
663,02-02-19,0,2,-2,0,0.006720698
664,01-02-19,1,1,0,-2,-0.001993401
665,31-01-19,0,1,-1,0,-0.002299069
666,30-01-19,0,0,0,-1,0.010807141
667,29-01-19,1,2,-1,0,-0.012384075
668,28-01-19,2,6,-4,-1,-0.030098532
669,27-01-19,0,1,-1,-4,-0.01350905
670,26-01-19,1,0,1,-1,0.009464644
671,25-01-19,2,3,-1,1,-0.001135306
672,24-01-19,3,3,0,-1,-0.002784004
673,23-01-19,6,1,5,0,0.004605543
674,22-01-19,4,3,1,5,0.003409182
675,21-01-19,1,1,0,1,-0.010633703
676,20-01-19,0,0,0,0,-0.034880484
677,19-01-19,0,0,0,0,0.023413648
678,18-01-19,3,0,3,0,0.002635096
679,17-01-19,1,5,-4,3,-0.000583728
680,16-01-19,2,2,0,-4,-0.006578701
681,15-01-19,1,6,-5,0,0.004563819
682,14-01-19,1,3,-2,-5,0.018936724
683,13-01-19,0,0,0,-2,-0.022391584
684,12-01-19,0,1,-1,0,-0.00343195
685,11-01-19,1,2,-1,-1,-0.034425279
686,10-01-19,3,1,2,-1,-0.065996241
687,09-01-19,0,3,-3,2,-0.002236145
688,08-01-19,0,4,-4,-3,-0.000284948
689,07-01-19,1,2,-1,-4,0.012609675
690,06-01-19,3,0,3,-1,0.033501423
691,05-01-19,0,1,-1,3,0.012454922
692,04-01-19,2,3,-1,-1,-0.008214309
693,03-01-19,1,0,1,-1,-0.003481627
694,02-01-19,1,0,1,1,0.031431349
695,01-01-19,1,1,0,1,-0.01090814
696,31-12-18,1,0,1,0,-0.009382502
697,30-12-18,1,1,0,1,-0.021414581
698,29-12-18,0,0,0,0,0.031755396
699,28-12-18,3,3,0,0,0.011417633
700,27-12-18,0,4,-4,0,-0.019787314
701,26-12-18,1,2,-1,-4,-0.001545581
702,25-12-18,0,1,-1,-1,-0.092609061
703,24-12-18,1,0,1,-1,0.037424163
704,23-12-18,0,0,0,1,0.028638767
705,22-12-18,0,2,-2,0,-0.025821845
706,21-12-18,4,4,0,-2,-0.003814522
707,20-12-18,0,0,0,0,0.053373815
708,19-12-18,2,4,-2,0,0.066167093
709,18-12-18,2,1,1,-2,0.03510429
710,17-12-18,5,6,-1,1,0.050623461
711,16-12-18,1,0,1,-1,0.01530702
712,15-12-18,0,3,-3,1,-0.014969995
713,14-12-18,5,1,4,-3,-0.038345961
714,13-12-18,4,2,2,4,-0.020157774
715,12-12-18,2,2,0,2,0.015399098
716,11-12-18,1,5,-4,0,-0.02661404
717,10-12-18,6,5,1,-4,-0.013815118
718,09-12-18,0,0,0,1,0.032051231
719,08-12-18,0,1,-1,0,0.008783203
720,07-12-18,3,5,-2,-1,-0.090428119
721,06-12-18,7,3,4,-2,-0.03418149
722,05-12-18,2,4,-2,4,-0.032459371
723,04-12-18,6,4,2,-2,0.000345777
724,03-12-18,5,0,5,2,-0.056917485
725,02-12-18,1,0,1,5,0.00654136
726,01-12-18,0,0,0,1,0.01439247
727,30-11-18,2,0,2,0,-0.048816082
728,29-11-18,4,4,0,2,0.031764949
729,28-11-18,2,3,-1,0,0.097600595
730,27-11-18,6,3,3,-1,-0.029164202
731,26-11-18,3,5,-2,3,0.009851411
732,25-11-18,0,2,-2,-2,-0.053516431
733,24-11-18,0,2,-2,-2,-0.06521665
734,23-11-18,2,1,1,-2,-0.047598341
735,22-11-18,1,3,-2,1,-0.003808818
736,21-11-18,3,3,0,-2,-0.001885313
737,20-11-18,6,9,-3,0,-0.141729127
738,19-11-18,8,4,4,-3,-0.089533948
739,18-11-18,0,0,0,4,0.010944061
740,17-11-18,1,0,1,0,-0.008148366
741,16-11-18,0,11,-11,1,0.013057854
742,15-11-18,4,24,-20,-11,-0.050044556
743,14-11-18,3,16,-13,-20,-0.097018612
744,13-11-18,2,5,-3,-13,-0.009389936
745,12-11-18,6,6,0,-3,0.00468099
746,11-11-18,1,0,1,0,-0.005606929
747,10-11-18,0,2,-2,1,-0.001639137
748,09-11-18,1,12,-11,-2,-0.013054711
749,08-11-18,5,6,-1,-11,-0.00977859
750,07-11-18,3,11,-8,-1,0.013568702
751,06-11-18,2,4,-2,-8,0.002696539
752,05-11-18,2,11,-9,-2,0.00026328
753,04-11-18,0,0,0,-9,0.010910135
754,03-11-18,0,0,0,0,-0.003257517
755,02-11-18,1,4,-3,0,0.005707749
756,01-11-18,7,20,-13,-3,0.005641957
757,31-10-18,1,3,-2,-13,0.002776766
758,30-10-18,6,9,-3,-2,-0.005664818
759,29-10-18,4,8,-4,-3,-0.016490419
760,28-10-18,0,0,0,-4,-0.000386009
761,27-10-18,0,0,0,0,-0.000689065
762,26-10-18,2,3,-1,0,0.001827594
763,25-10-18,2,9,-7,-1,-0.005079012
764,24-10-18,7,2,5,-7,0.005646989
765,23-10-18,8,4,4,5,-0.001405225
766,22-10-18,4,5,-1,4,-0.004799469
767,21-10-18,0,0,0,-1,0.005496992
768,20-10-18,0,0,0,0,0.002245054
769,19-10-18,3,13,-10,0,-0.005476283
770,18-10-18,5,2,3,-10,-0.002746432
771,17-10-18,4,2,2,3,-0.000493807
772,16-10-18,2,6,-4,2,-0.002763445
773,15-10-18,6,4,2,-4,0.034452396
774,14-10-18,0,0,0,2,0.006453796
775,13-10-18,0,1,-1,0,1.89E-05
776,12-10-18,2,1,1,-1,-0.001329282
777,11-10-18,2,4,-2,1,-0.046542455
778,10-10-18,4,3,1,-2,-0.014432248
779,09-10-18,5,2,3,1,-0.001342452
780,08-10-18,2,2,0,3,0.006102155
781,07-10-18,0,0,0,0,0.000177521
782,05-10-18,2,5,-3,0,0.000537187
783,04-10-18,3,2,1,-3,0.01649013
784,03-10-18,1,3,-2,1,-0.013081278
785,02-10-18,0,1,-1,-2,-0.004997091
786,01-10-18,3,1,2,-1,-0.002463174
787,30-09-18,0,0,0,2,0.004932668
788,29-09-18,0,1,-1,0,-0.017955643
789,28-09-18,5,1,4,-1,0.01472847
790,27-09-18,0,5,-5,4,0.014009745
791,26-09-18,3,5,-2,-5,0.008700865
792,25-09-18,2,2,0,-2,-0.032753009
793,24-09-18,4,3,1,0,-0.012854705
794,23-09-18,0,0,0,1,0.001408825
795,22-09-18,0,1,-1,0,0.004101273
796,21-09-18,3,2,1,-1,0.038613534
797,20-09-18,3,6,-3,1,0.013346292
798,19-09-18,4,3,1,-3,0.003731935
799,18-09-18,1,7,-6,1,-0.002801843
800,17-09-18,4,3,1,-6,-0.021066823
801,16-09-18,0,0,0,1,-0.009687889
802,15-09-18,1,0,1,0,0.00411458
803,14-09-18,2,2,0,1,0.004932981
804,13-09-18,2,4,-2,0,0.029766507
805,12-09-18,2,6,-4,-2,-0.002694302
806,11-09-18,4,8,-4,-4,4.30E-05
807,10-09-18,5,4,1,-4,-0.00052705
808,09-09-18,1,0,1,1,0.001068266
809,08-09-18,1,0,1,1,-0.024275748
810,07-09-18,3,6,-3,1,0.003078114
811,06-09-18,3,3,0,-3,-0.094593298
812,05-09-18,0,7,-7,0,-0.044355891
813,04-09-18,1,8,-7,-7,0.00990675
814,03-09-18,3,3,0,-7,0.001722307
815,02-09-18,1,0,1,0,0.011970803
816,01-09-18,0,0,0,1,0.024945226
817,31-08-18,1,6,-5,0,0.010373926
818,30-08-18,3,2,1,-5,-0.018180375
819,29-08-18,0,4,-4,1,0.004720453
820,28-08-18,3,0,3,-4,0.037425784
821,27-08-18,3,4,-1,3,0.011804115
822,26-08-18,0,0,0,-1,-0.00777837
823,25-08-18,1,0,1,0,0.022141087
824,24-08-18,2,2,0,1,0.01947235
825,23-08-18,0,4,-4,0,-0.016177796
826,22-08-18,3,5,-2,-4,0.020658049
827,21-08-18,2,4,-2,-2,0.000543596
828,20-08-18,0,0,0,-2,-0.002735491
829,19-08-18,0,0,0,0,-0.002977517
830,18-08-18,0,5,-5,0,-0.005819462
831,17-08-18,5,5,0,-5,0.019908567
832,16-08-18,2,1,1,0,-0.009468279
833,15-08-18,1,0,1,1,0.056432736
834,14-08-18,7,6,1,1,-0.048770532
835,13-08-18,1,2,-1,1,0.004898004
836,12-08-18,0,1,-1,-1,0.014674908
837,11-08-18,0,2,-2,-1,-0.016940885
838,10-08-18,4,2,2,-2,-0.010396902
839,09-08-18,5,5,0,2,-0.005191167
840,08-08-18,2,2,0,0,-0.079792845
841,07-08-18,0,4,-4,0,-0.003319559
842,06-08-18,1,5,-4,-4,-0.004409829
843,05-08-18,0,0,0,-4,-0.023015536
844,04-08-18,0,0,0,0,-0.034970162
845,03-08-18,5,4,1,0,-0.02579815
846,02-08-18,6,4,2,1,0.003110758
847,01-08-18,4,2,2,2,-0.037064128
848,31-07-18,9,3,6,2,-0.033252824
849,30-07-18,6,6,0,6,-0.012681495
850,29-07-18,0,3,-3,0,0.004336002
851,28-07-18,0,0,0,-3,0.019006092
852,27-07-18,6,1,5,0,-0.015241966
853,26-07-18,6,3,3,5,-0.012469504
854,25-07-18,6,4,2,3,0.018445539
855,24-07-18,6,3,3,2,0.050330725
856,23-07-18,4,4,0,3,0.029959992
857,22-07-18,2,0,2,0,0.017176903
858,21-07-18,0,1,-1,2,-0.015095846
859,20-07-18,8,5,3,-1,0.003826716
860,19-07-18,6,4,2,3,-0.00218892
861,18-07-18,0,4,-4,2,0.051257212
862,17-07-18,3,1,2,-4,0.067010265
863,16-07-18,4,2,2,2,0.035530134
864,15-07-18,0,0,0,2,0.014952137
865,14-07-18,0,0,0,0,0.001033351
866,13-07-18,3,3,0,0,0.006560045
867,12-07-18,2,5,-3,0,-0.024539756
868,11-07-18,2,2,0,-3,-0.01606557
869,10-07-18,4,9,-5,0,-0.040259155
870,09-07-18,2,5,-3,-5,-0.004630415
871,08-07-18,1,0,1,-3,0.018166999
872,07-07-18,0,1,-1,1,0.010869974
873,06-07-18,2,3,-1,-1,-0.005696156
874,05-07-18,3,2,1,-1,0.000763616
875,04-07-18,2,7,-5,1,-0.001140817
876,03-07-18,2,1,1,-5,0.013434929
877,02-07-18,3,0,3,1,0.022477014
878,01-07-18,0,0,0,3,-0.003347251
879,30-06-18,0,0,0,0,0.06813937
880,29-06-18,2,2,0,0,-0.01418401
881,28-06-18,2,3,-1,0,-0.011761354
882,27-06-18,2,6,-4,-1,-0.015533294
883,26-06-18,2,2,0,-4,-0.003035314
884,25-06-18,6,8,-2,0,0.035013974
885,24-06-18,0,0,0,-2,-0.025041425
886,23-06-18,1,1,0,0,-0.023741555
887,22-06-18,0,7,-7,0,-0.071413094
888,21-06-18,2,4,-2,-7,0.007752009
889,20-06-18,3,7,-4,-2,-0.007771216
890,19-06-18,3,3,0,-4,0.026783306
891,18-06-18,3,3,0,0,0.006459097
892,15-06-18,4,3,1,0,0.007904534
893,14-06-18,1,1,0,1,0.014724824
894,13-06-18,3,6,-3,0,-0.046232349
895,12-06-18,2,3,-1,-3,-0.009085694
896,11-06-18,2,9,-7,-1,-0.031200725
897,10-06-18,0,1,-1,-7,-0.090774437
898,09-06-18,0,1,-1,-1,-0.002541448
899,08-06-18,1,4,-3,-1,-0.010278054
900,07-06-18,3,1,2,-3,0.011747439
901,06-06-18,1,2,-1,2,0.014573082
902,05-06-18,3,6,-3,-1,-0.009246412
903,04-06-18,1,5,-4,-3,-0.01694214
904,03-06-18,0,0,0,-4,0.012489745
905,02-06-18,0,0,0,0,0.015169814
906,01-06-18,0,2,-2,0,-0.004457001
907,31-05-18,5,4,1,-2,0.010670869
908,30-05-18,1,3,-2,1,0.016158493
909,29-05-18,1,8,-7,-2,0.01033568
910,28-05-18,0,4,-4,-7,-0.01034982
911,27-05-18,1,0,1,-4,-0.022154021
912,26-05-18,2,1,1,1,0.000807582
913,25-05-18,0,4,-4,1,-0.005593679
914,24-05-18,2,5,-3,-4,-0.02788173
915,23-05-18,0,11,-11,-3,-0.060798075
916,22-05-18,0,2,-2,-11,-0.03197012
917,21-05-18,2,4,-2,-2,0.009099876
918,20-05-18,1,1,0,-2,0.014046626
919,19-05-18,2,0,2,0,0.020229398
920,18-05-18,1,1,0,2,-0.020914709
921,17-05-18,2,4,-2,0,-0.001223895
922,16-05-18,6,2,4,-2,-0.044584909
923,15-05-18,3,6,-3,4,0.004833144
924,14-05-18,3,6,-3,-3,0.003095897
925,13-05-18,2,0,2,-3,0.018654867
926,12-05-18,0,0,0,2,-0.034203405
927,11-05-18,2,5,-3,0,-0.061813579
928,10-05-18,3,2,1,-3,0.006488205
929,09-05-18,4,3,1,1,-0.006256662
930,08-05-18,0,2,-2,1,-0.010363507
931,07-05-18,1,5,-4,-2,-0.027294361
932,06-05-18,1,1,0,-4,-0.025581862
933,05-05-18,0,0,0,0,0.017779973
934,04-05-18,1,2,-1,0,0.02407519
935,03-05-18,4,6,-2,-1,0.032908743
936,02-05-18,3,4,-1,-2,0.014071303
937,01-05-18,0,3,-3,-1,-0.032373049
938,30-04-18,5,2,3,-3,-0.008837489
939,29-04-18,0,1,-1,3,0.012499289
940,28-04-18,1,1,0,-1,0.004208662
941,27-04-18,0,0,0,0,0.034541241
942,26-04-18,3,2,1,0,-0.033454968
943,25-04-18,3,7,-4,1,-0.015522225
944,24-04-18,5,4,1,-4,0.046204709
945,23-04-18,2,2,0,1,4.48E-05
946,22-04-18,1,0,1,0,0.010180971
947,21-04-18,0,2,-2,1,0.035714679
948,20-04-18,3,4,-1,-2,0.032394143
949,19-04-18,1,3,-2,-1,0.016268539
950,18-04-18,3,5,-2,-2,0.006227743
951,17-04-18,6,5,1,-2,-0.008878692
952,16-04-18,3,2,1,1,-0.019483248
953,15-04-18,0,0,0,1,0.028270555
954,14-04-18,1,3,-2,0,-0.001156844
955,13-04-18,2,2,0,-2,0.060176951
956,12-04-18,1,2,-1,0,0.086520324
957,11-04-18,2,8,-6,-1,0.015709466
958,10-04-18,2,1,1,-6,-0.007777288
959,09-04-18,0,6,-6,1,-0.023933701
960,08-04-18,0,1,-1,-6,0.015247529
961,07-04-18,0,0,0,-1,0.037207886
962,06-04-18,0,3,-3,0,-0.016284041
963,05-04-18,3,7,-4,-3,-0.042059022
964,04-04-18,2,1,1,-4,-0.043164401
965,03-04-18,2,3,-1,1,0.047788598
966,02-04-18,3,0,3,-1,0.03915144
967,31-03-18,0,0,0,3,0.023628882
968,30-03-18,1,2,-1,0,-0.080153156
969,29-03-18,2,0,2,-1,-0.070296688
970,28-03-18,0,2,-2,2,-0.003087807
971,27-03-18,0,0,0,-2,-0.032318469
972,26-03-18,0,1,-1,0,-0.037940635
973,25-03-18,0,0,0,-1,-0.034851909
974,24-03-18,0,0,0,0,0.0338522
975,23-03-18,1,2,-1,0,-0.025083851
976,22-03-18,7,3,4,-1,-0.02763767
977,21-03-18,0,1,-1,4,0.035180817
978,20-03-18,1,1,0,-1,0.03268634
979,19-03-18,2,4,-2,0,0.08184824
980,18-03-18,2,1,1,-2,-0.050102377
981,16-03-18,0,0,0,1,0.02824169
982,15-03-18,2,1,1,0,-0.063889542
983,14-03-18,0,1,-1,1,-0.064489894
984,13-03-18,1,1,0,-1,-0.020248704
985,12-03-18,2,7,-5,0,0.022584066
986,11-03-18,0,0,0,-5,-0.004466916
987,09-03-18,0,0,0,0,-0.089290371
988,08-03-18,3,3,0,0,-0.047775368
989,07-03-18,0,0,0,0,-0.083946549
990,06-03-18,0,3,-3,0,-0.052830082
991,05-03-18,0,1,-1,-3,0.022562146
992,04-03-18,0,0,0,-1,-0.004694989
993,02-03-18,0,1,-1,0,0.023043641
994,01-03-18,1,0,1,-1,0.009591413
995,28-02-18,1,0,1,1,0.004493551
996,27-02-18,1,1,0,1,0.050199776
997,26-02-18,0,1,-1,0,0.049685015
998,25-02-18,0,0,0,-1,-0.033088449
999,23-02-18,0,0,0,0,-0.017645457
1000,22-02-18,0,0,0,0,-0.057976384
1001,21-02-18,0,1,-1,0,-0.063091029
1002,20-02-18,0,0,0,-1,0.047534642
1003,19-02-18,0,0,0,0,0.019767724
1004,18-02-18,0,0,0,0,0.000544722
1005,16-02-18,0,1,-1,0,0.019217597
1006,15-02-18,0,0,0,-1,0.0751202
1007,14-02-18,1,0,1,0,0.055462531
1008,13-02-18,0,2,-2,1,-0.00865507
1009,12-02-18,0,5,-5,-2,0.05972754
1010,11-02-18,0,0,0,-5,-0.063474519
1011,10-02-18,0,0,0,0,0.047042649
1012,09-02-18,2,0,2,0,0.003257253
1013,08-02-18,0,4,-4,2,0.029397856
1014,07-02-18,1,0,1,-4,0.139760346
1015,06-02-18,0,0,0,1,-0.070210494
1016,05-02-18,1,6,-5,0,-0.152997454
1017,04-02-18,0,0,0,-5,-0.053210423
1018,02-02-18,0,1,-1,0,-0.096675336
1019,01-02-18,1,1,0,-1,-0.078275334
1020,31-01-18,0,1,-1,0,-0.045432221
1021,30-01-18,0,5,-5,-1,-0.085497216
1022,29-01-18,0,1,-1,-5,-0.037198797
1023,28-01-18,0,1,-1,-1,0.035590691
1024,27-01-18,0,2,-2,-1,0.03609521
1025,26-01-18,0,3,-3,-2,-0.038696009
1026,25-01-18,0,1,-1,-3,0.021286015
1027,24-01-18,1,1,0,-1,0.03372494
1028,23-01-18,1,5,-4,0,-0.019787505
1029,22-01-18,0,4,-4,-4,-0.085096215
1030,21-01-18,0,0,0,-4,-0.055772146
1031,19-01-18,0,1,-1,0,-0.003299778
1032,18-01-18,4,2,2,-1,0.092187647
1033,17-01-18,1,3,-2,2,-0.126603043
1034,16-01-18,0,0,0,-2,-0.175883933
1035,15-01-18,0,1,-1,0,0.023865323
1036,14-01-18,0,0,0,-1,-0.050885308
1037,13-01-18,0,1,-1,0,0.040807851
1038,12-01-18,0,0,0,-1,0.004326324
1039,11-01-18,0,2,-2,0,-0.039855843
1040,10-01-18,1,0,1,-2,-0.040188301
1041,09-01-18,2,4,-2,1,-0.027222959
1042,08-01-18,0,1,-1,-2,-0.085636067
1043,07-01-18,1,0,1,-1,-0.016678024
1044,05-01-18,1,1,0,1,0.073558442
1045,04-01-18,1,2,-1,0,-0.010382007
1046,03-01-18,0,0,0,-1,0.060329549
1047,02-01-18,2,0,2,0,0.048684699
1048,01-01-18,0,0,0,2,0.002310777
1049,31-12-17,1,0,1,0,0.014511315
1050,29-12-17,1,2,-1,1,0.023014219
1051,28-12-17,0,0,0,-1,-0.091947127
1052,27-12-17,0,2,-2,0,0.007634912
1053,26-12-17,0,2,-2,-2,0.090637505
1054,25-12-17,1,0,1,-2,0.03059665
1055,24-12-17,0,0,0,1,-0.093188378
1056,23-12-17,0,0,0,0,0.090896088
1057,22-12-17,0,1,-1,0,-0.192847614
1058,21-12-17,1,0,1,-1,-0.043111264
1059,20-12-17,0,0,0,1,-0.075409595
1060,19-12-17,1,5,-4,0,-0.036048196
1061,18-12-17,0,1,-1,-4,-0.025534763
1062,17-12-17,0,1,-1,-1,0.035559675
1063,15-12-17,0,3,-3,-1,0.056746178
1064,14-12-17,0,0,0,-3,-0.005114163
